XXXXXXXXXXXXXXXXXXX
X........X........X
X.XX.XXX.X.XXX.XX.X
X........*........X
X.XX.X.XXXXX.X.XX.X
X....X.......X...*X
XXXX.XXXX.XXXX.XXXX
OOOX.X.......X.XOOO
XXXX.X.XXrXX.X.XXXX
O.......bpo.......O
XXXX.X.XXXXX.X.XXXX
X........X........X
X.XX.XXX.X.XXX.XX.X
X..X.....P.....X..X
XX.X.X.XXXXX.X.X.XX
X....X...X...X....X
X.XXXXXX.X.XXXXXX.X
X........*........X
XXXXXXXXXXXXXXXXXXX